################################################################
#..............................................................#
#....11111.....................................................#
#..............................................................#
#.........############.........................................#
#..............................................................#
#..................##########################..................#
#.........11111.............................#..................#
#...................######################..#..................#
#...........................................#..................#
#...................#######.................#..................#
#.........................###################..................#
#..............................................................#
#.........##...................................................#
#..............................................................#
################################################################
