################################################################
#..............................................................#
#..............................................................#
#..............................................................#
#.........................#########....1.......................#
#.............................#................................#
#.............................#................................#
#.............................#................................#
#.............................#................................#
#.........................#########............................#
#..............................................................#
#..............................................................#
#..............................................................#
#..............................................................#
#..............................................................#
################################################################
