20 15
####################
#p.................#
#..............R...#
#..................#
#..................#
#..................#
#..................#
#..................#
#..................#
#..................#
#.......6..........#
#..................#
#....4....4........#
#................E.#
####################
