20 15
####################
#p.................#
#..............R...#
#..................#
#..................#
#..................#
#..................#
#..................#
#........5.........#
#..................#
#......6....6......#
#.....4......4.....#
#........7.........#
#................E.#
####################
