20 15
####################
#p.................#
#..............R...#
#..................#
#..................#
#..................#
#..................#
#....#######.......#
#..................#
#........5.........#
#............6.....#
#......5...........#
#.........6..7.....#
#................E.#
####################
