64 16
################################################################
#..............................................................#
#..............................................................#
#..............................................................#
#.........................#########....1.......................#
#.............................#................................#
#...####......................#................................#
##.......#....................#................................#
#...####......................#............1...................#
#.........................#########............................#
#..............................................................#
#......................................1........E..............#
#................................1.............................#
#..............................................................#
#..............................................................#
################################################################
