20 15
####################
#p.................#
#..............R...#
#..................#
#..................#
#..................#
#..................#
#....#######.......#
#..................#
#..................#
#........7.........#
#..................#
#..................#
#................E.#
####################
