20 15
####################
#p.................#
#..............R...#
#..................#
#..................#
#..................#
#..................#
#..................#
#..................#
#..................#
#.....6....6.......#
#..................#
#..................#
#.......7........E.#
####################
